000700040
020801900
000000173
102006097
600090001
970100405
354000000
008604030
010003000